1111111111111
11111111110C1
1111111111001
111111E000001
1111111111111