111111111111111
1P0000010000001
101110101011111
100C00101000001
111110101111101
10001000100C001
101011111011101
111111111111111