111111111111111111111111111111
1CCCCCCCCCCCC11CCCCCCCCCCCC1E1
1CC111CC111CC11CC111CC111CC1C1
1CCCCCCCCCCCCCCCCCCCCCCCCCC1C1
1CC111CC11CCCCCC11CC111CC11CC1
1CCCCCC11CC1111CC11CCCCCCCC1C1
111111CC11C1CC1C11CC11111111C1
1CCCCCCC11C1CC1C11CC1CCCCCCCC1
111111CC11C1CC1C11CC11111111C1
1CCCCCC11CC1CC1CC11CCCCCCCCCC1
1CC111CC11CCCCCC11CC111CC111C1
1CCCCCCCCCCCCPCCCCCCCCCCCCCC11
1CC111CC111CC11CC111CC111CC111
1CCCCCCCCCCCC11CCCCCCCCCCCCCC1
1CC111CC111CC11CC111CC111CC111
111111111111111111111111111111