11111111111
10P0000C001
10000C000E1
11111111111